NO assets/textures/NO.png
SO assets/textures/SO.png

EA assets/textures/EA.png
WE assets/textures/WE.png




F 51, 47, 44
C 119, 119, 119








     1111111111111111111111    1111111111111
111111100000000000000000011    1000000000111
100000000000000000000000001111111000000000001
100000000000000000000001000000000000000000001
100000100000000101010000000001111000000000001
100000100010000000000000000001  1000000000001
111111100010000100010000000001  1111111111111
1111111000101000100000000000011
1111111111110000111111111111111
100000000001000100000001
10000000000010010000000111111111111111111111
10000000000001010000000000000000000000000001
10000000000000111111111111111111111111111001
10000000000000010000000100000000000000000001
10000000000000000000000101111111111111111111
100000000000000N0000000100000000001
11111111100000000000000100000000001
110100001000000000000001111111111111
11000010100000000000001000000000001
110100001000000000000001000011111111
1101111110000000000000000001
1100000000000000000000000001
1100000000001000000000000001
1111111111111111111111111111
