NO assets/textures/NO.png
SO assets/textures/SO.png
EA assets/textures/EA.png
WE assets/textures/WE.png


F      17,    38,     64




C 218, 234, 235






11111111111111
            1111
      1111110000111111
11111100000000000000001111111
1000000000000000000000001
1111110000000000000000001
      10000000000000000011111       
      10000000000000000000001 1111
111111000000000000000N0000001 1001
10000000111100000000000000001 1111
10000001    10000000000000001
11111111    11111111111111111
                      
                  111111
                  100001
                  100001
                  111111111111
