NO assets/textures/NO.png
SO assets/textures/SO.png
EA assets/textures/EA.png
WE assets/textures/WE.png


F 40,40,40




C 0,     150, 255






11111111111111
            1111
      1111110000111111
11111100000000000000001111111
1000000000000000000000001     1
1111110000000000000000001  11
      10000000000000000011101       
      10000000000000000000W1011111
11111100000000000000000000001 1001
10000000111100000000010000011 1111
10000001    10000000000000001
11111111    11111111111111111
                      
                  111111
                  100001
                  100001
                  111111111111
