NO assets/textures/NO.xpm42
SO assets/textures/SO.xpm42
EA assets/textures/EA.xpm42
WE assets/textures/WE.xpm42


F 17,38,64




C 218,234,235





1111111111111111111111111
1000000000000000000000001
1000000000000000000000001
1000000000000000000000001
1000000000000000000000001
100000000000000000000N001
1000000000000000000000001
1000000000000000000000001
1111111111111111111111111
