NO assets/textures/NO.png
SO assets/textures/SO.png
EA assets/textures/EA.png
WE assets/textures/WE.png

C 250,0,0

F 255,255,255

1111111111111111111111
1100000000000000000001
1N10000000000000000001
1100000000000000000001
1000000000000000000001
1000000000000000000001
1000000000000000000001
1111111111111111111111