NO assets/textures/NO.png
SO assets/textures/SO.png
EA assets/textures/EA.png
WE assets/textures/WE.png

C 50,50,50

F 40,40,40

1111111111111111111111
1000N00000000000000001
1000000000000000000001
1000000000000000000001
1000000000000000000001
1000000000000000000001
1000000000000000000001
1111111111111111111111