NO assets/textures/NO.xpm42
SO assets/textures/SO.xpm42
EA assets/textures/EA.xpm42
WE assets/textures/WE.xpm42

C 0,255,255

F 255,b,c

11111111111111111111111111111111111111111111111111111111111111111111111
1000N000000000000000000000000000000000000000000000000000000000000000001
10000000000000000000000000000000000000000000000000000000000000000000001
10000000000000000000000000000000000000000000000000000000000000000000001
10000000000000000000000000000000000000000000000000000000000000000000001
10000000000000000000000000000000000000000000000000000000000000000000001
10000000000000000000000000000000000000000000000000000000000000000000001
11111111111111111111111111111111111111111111111111111111111111111111111