NO ./textures/north.cub
SO ./textures/north.cub
WE ./textures/west.cub
EA ./textures/east.cub

F 100,100,100
C 200,200,200




111111111111111111111111111111111111111111111
100000000000000000000000000000000000000000001
100000000000000000000000000000000011111111111
10000000000000000000000000000000001
111111111111110011111111111111111111111111111111111111
             10000000000000000000000000000000000000001
             10000000000000000000000000000000000000001
             10000000000000000000000000000000000000001
             11111111111111111111111111111111111111111
